LN=LEVELBEGINNER
GD=3000
ET=10
ED=3
ER=2
RS=5
PR=3
PO=7
WWWWWWWWWWWWWWWWWWW
W-2-----R----O----W
WWOW-W-W-W-W-W-W-WW
W-O--------R------W
WWOWOW-W-W-W-WOW-WW
W--O--------O-R--3W
WWOW-W-W-W-W-W-W-WW
W-OOOO---1-------OW
WWOWOWOWOW-W-W-W-WW
W--OOOO--R--OOO---W
WW-W-WOWOW-WOWOWOWW
W------OOO--OOO-ORW
WWWWWWWWWWWWWWWWWWW