LN=LEVELBEGINNER
GD=1200000
ET=4000
ED=4000
ER=20
RS=5
PR=3
PO=7
WWWWWWWWWWWWWWWW
W-2----R--O----W
WWOWWWWWWWWWWWWW
W-O-----OOOO---W
WWOW-W-W-W-W-W-W
W-----O---O--O-W
W-WOW-W-W-W-W-WW
WW-W-W-WOW-W-W-W
W--O----O-O-R-3W
W-W-W-W-W-W-W-WW
WWOW-W-W-W-W-W-W
W-OOOO---1----OW
W-W-W-W-W-W-W-WW
WWOWOWOWOW-W-W-W
WOOO--R--OOO---W
W-W-WOWOWOWOWOWW
W---OOO--OOO-ORW
WWWWWWWWWWWWWWWW