LN=1
GD=120000
ET=2000
ED=2000
ER=100
RS=500
PR=10
PO=100
WWWWWWWWWWWWWWWW
W-2----R---O---W
WWOWW-W-WW-W-WWW
WWOWW-W-WW-W-WWW
W-O------R-----W
WWOWOWW-WW-WOWWW
WWOWOWW-WW-WOWWW
W--O-----O-R--3W
WWOW-WW-WW-WW-WW
WWOW-WW-WW-WW-WW
W-OOOO--1-----OW
WWOWOWOWOWWW-WWW
WWOWOWOWOWWW-WWW
W-OOOO--R-OOO--W
WWWWOWOWWOWOWOWW
WWWWOWOWWOWOWOWW
W---OOO--OOO-ORW
WWWWWWWWWWWWWWWW