LN=level3
GD=120000
ET=1000
ED=1000
ER=60
RS=4
PR=10
PO=100
WWWWWWWWWWWWWWWW
W--O------O-R-3W
WWOWW-W-WW-W-WWW
WWOWW-W-WW-W-WWW
W-OOOO--1-----OW
WWOWOWOWOWWW-WWW
WWOWOWOWOWWW-WWW
W-2---R---O----W
WWOWW-W-WW-WW-WW
WWOWW-W-WW-WW-WW
W-O-------R----W
WWOWOWW-WW-WOWWW
WWOWOWW-WW-WOWWW
W--OOOO-R--OOO-W
WWWWOWOWWOWOWOWW
WWWWOWOWWOWOWOWW
W--4OOO--OO---RW
WWWWWWWWWWWWWWWW