LN=2
GD=120000
ET=1500
ED=1000
ER=60
RS=1000
PR=10
PO=100
WWWWWWWWWWWWWWWW
W-2----R---O---W
WWOWW-W-WW-W-WWW
WWOWW-W-WW-W-WWW
W-O--O---R-----W
WWOWOWWWW-WOW-WW
WWOWOWWWW-WOW-WW
W--O--1--O-R--3W
WWW-W-WW-W-W-W-W
WWW-W-WW-W-W-W-W
W-O-O--O--O-O-OW
W-O-O--O--O-O-OW
WWOWWOWOW-WW-WWW
WWOWWOWOW-WW-WWW
W-O-OO--R---W--W
WWWRWOWOWOWOWOWW
W4---ROO-O-O-ORW
WWWWWWWWWWWWWWWW