LN=LEVELINTERMEDIATE
GD=1200000
ET=4000
ED=2000
ER=40
RS=5
PR=3
PO=7
WWWWWWWWWWWWWWWW
W-2----OOOO---RW
WWOWWWWWWOOWWWWW
W-O--OOOOOOO---W
WWOWOW-W-W-W-W-W
W-OOOOO---O--O-W
W-WOOOW-W-OOOOWW
WW-W---OOW-W-W-W
W--O-R--OOO---3W
W-W-W-OOWOO-W-WW
WWOOOWOWOWOWOWOW
W-OOOO---1--OOOW
W-W-W---W---W-WW
WWOWOWOWOO-W-W-W
WOOO--R--OOOOOOW
W-W-WOWOWOWOWOWW
WR---OOOOOOO-O-W
WWWWWWWWWWWWWWWW