LN=LEVELBEGINNER
GD=1200000
ET=4000
ED=4000
ER=20
RS=5
PR=3
PO=7
WWWWWWWWWWWWWWWW
W-2----R--O----W
WWOWWWWWWOOWWWWW
W-O-----OOOO---W
WWOW-W-W-W-W-W-W
W-----O---O--O-W
W-WO--W-W-----WW
WW-W---OOW-W-W-W
W--O----O-O-R-3W
W-W-W-OOWOO-W-WW
WWO--W-W-W-W-W-W
W-OOOO---1----OW
W-W-W---W---W-WW
WWOWOWOWOO-W-W-W
WOOO--R--OOO---W
W-W-WOWOWOWOWOWW
W---OOO--OOO-ORW
WWWWWWWWWWWWWWWW