LN=LEVELADVANCED
GD=600000
ET=6000
ED=2000
ER=60
RS=5
PR=3
PO=7
WWWWWWWWWWWWWWWW
W-2---OOOO----RW
WWOWWWWWWOOWWWWW
WOOOOOOOOOOOOOOW
WWOWOWOWOWOWOWOW
WOOOOOOOOOOOOOOW
WOWOOOWOWOOOOOWW
WWOWOOOOOWOWOWOW
WOO--R--OO----3W
WOWOWOOOWOOOWOWW
WWOOOWOWOWOWOWOW
WOOOOO---1-OOOOW
WOWOWOOOWOOOWOWW
WWOWOWOWOOOWOWOW
WOOO--R--OOOOOOW
WOWOWOWOWOWOWOWW
WR----OOOOOOOOOW
WWWWWWWWWWWWWWWW