LN=LEVELBEGINNER
GD=180000
ET=2000
ED=2000
ER=20
RS=5
PR=25
PO=30
WWWWWWWWWWWWWWWW
W-2-------O---RW
WWOWWWWWWOOWWWWW
W-O-----OOOO---W
WWOW-W-W-W-W-W-W
W-----O---O--O-W
W-WO--W-W-----WW
WW-W---OOW-W-W-W
W--O-R--O-O---3W
W-W-W-OOWOO-W-WW
WWO--W-W-W-W-W-W
W-OOOO--------OW
W-W-W---W1--W-WW
WWOWOWOWOO-W-W-W
WOOO--R--OOO---W
W-W-WOWOWOWOWOWW
WR--OOO--OOO-O-W
WWWWWWWWWWWWWWWW